//  Level 1
//  Pamiętaj, że tu się zmieni góra z dołem!

- - - - - - - - - - - - - - - - - - - -
- - - - - - - - - - - - - - - - - - - -
- - * * - - - - - - - - - - - - - - - -
- - - - - - - - - - - - - - - - - - - -
- - - * - - - - - - - - - - - - - - - -
- - - * - - - - - - - - - - - - - - - -
- X - * - $ - P - - - - - - - - - - - -
- - - * - - - - - - - - - - - - - - - -
- - - * - - - - - - - - - - - - - - - -
- - - * - - - - - - - - - - - - - - - -
- X - * - $ - - - - - - - - - - - - - -
- - - * - - - - - - - - - - - - - - - -
- - - * - - - - - - - - - - - - - - - -
- - - * - - - - - - - - - - - - - - - -
- - - * - - - - - - - - - - - - - - - -
- - - * - - - - - - - - - - - - - - - -
- - - * - - - - - - - - - - - - - - - -
- - - * - - - - - - - - - - - - - - - -
- - - - - - - - - - - - - - - - - - - -
- - - - - - - - - - - - - - - - - - - -
